15
17
...###....#...#
######.##d#.#.#
#e...#.#......#
#..#...#.###..#
#..#...#...d..#
##..#.##..#..##
##d#.x..#.#.#.#
#....#.##..#..#
##..##.#.#.#.##
.#...#.......##
...#...###.#..#
.##..##.#..##.#
..##.....#.##.#
#..#.#.##....##
#.#..#.##.#.#.#
#...##....#...#
###############