10
12
##########
#.....x.##
###..#####
##.....#.#
#####.##.#
####..##.#
###..#.#.#
###.#..#.#
###.#.##.#
###.#.##.#
###......#
##########